11111111111111
10P00000000001
10000111111111
10000000000001
100000000C0001
100E0010000001
1000001000C001
11111111111111