111111111111111
10P000000000001
100000111111111
100000000000001
1000000000C0001
100000100000001
1000001E0000001
111111111111111