11111111111111
10P00000000001
10000111111111
10000000000001
100000000C0001
10000010000001
1000001E000001
11111111111111
