11111111111111
10000000000001
1000000000C001
10000000000001
10000000000001
P0000000000001
10000000000001
11111111111111
